1111111111111111111111111111111111
100000000011111111000000C100111001
100000000000000000000000C100000001
1011111111111111111111111101111111
1000000000000000000000000000000001
1011111111111111111111111111111111
1000000000000000000000000000000001
1111111111111111111111111111110111
10000000000000000000000000000001C1
1011111111111111111111111111111101
1000000000000000000000000000000001
1111111111111111111111110111111111
10000000000000000000000001000001C1
1011111111111111111111111101110101
1000000000000000000000000000E10001
1111111111111111111111110111110011
10000000P0000000000000000001000101
1111111111111111111111111111111111