1111
1CE1
1CC1
1CC1
1CC1
1PC1
1111