11111111111
1C000000001
100E0P00001
10000000001
11111111111