111111111111
100000000CE1
111100000CC1
100010000001
101011111101
101010000101
1P1000111001
111111111111